//MAP CONVERTED BY dmm2tgm.py THIS HEADER COMMENT PREVENTS RECONVERSION, DO NOT REMOVE
"a" = (
/obj/modular_map_connector,
/obj/machinery/atmospherics/pipe/smart/manifold4w/supply/hidden/layer4,
/obj/machinery/atmospherics/pipe/smart/manifold4w/scrubbers/hidden/layer2,
/turf/open/floor/iron/grimy,
/area/ruin/syndicate_lava_base/dormitories)
"q" = (
/obj/effect/mob_spawn/ghost_role/human/lavaland_syndicate{
	dir = 8
	},
/obj/machinery/airalarm/directional/north,
/obj/effect/mapping_helpers/airalarm/syndicate_access,
/turf/open/floor/iron/grimy,
/area/ruin/syndicate_lava_base/dormitories)
"u" = (
/obj/machinery/light/small/directional/north,
/obj/machinery/atmospherics/components/unary/vent_pump/on/layer4,
/turf/open/floor/iron/grimy,
/area/ruin/syndicate_lava_base/dormitories)
"X" = (
/obj/structure/closet/syndicate,
/obj/item/ammo_box/magazine/m9mm,
/obj/item/ammo_box/magazine/m9mm,
/obj/machinery/atmospherics/components/unary/vent_scrubber/on/layer2{
	dir = 8
	},
/obj/item/ammo_box/magazine/sniper_rounds,
/obj/item/crowbar/red,
/turf/open/floor/iron/grimy,
/area/ruin/syndicate_lava_base/dormitories)

(1,1,1) = {"
u
a
"}
(2,1,1) = {"
q
X
"}
