//MAP CONVERTED BY dmm2tgm.py THIS HEADER COMMENT PREVENTS RECONVERSION, DO NOT REMOVE
"aa" = (
/turf/template_noop,
/area/template_noop)
"ab" = (
/obj/machinery/conveyor/auto{
	id = "hellfactory_logistics_conveyors"
	},
/obj/effect/decal/cleanable/dirt,
/turf/open/floor/plating,
/area/ruin/space/has_grav/hellfactory)
"ac" = (
/turf/closed/wall/r_wall,
/area/ruin/space/has_grav/hellfactory)
"ad" = (
/obj/structure/cable,
/obj/machinery/power/apc/auto_name/directional/north,
/turf/open/floor/plating,
/area/ruin/space/has_grav/hellfactory)
"ae" = (
/obj/machinery/atmospherics/pipe/layer_manifold/visible{
	dir = 4
	},
/obj/structure/closet/secure_closet/freezer/meat,
/turf/open/floor/iron/showroomfloor,
/area/ruin/space/has_grav/hellfactory)
"af" = (
/obj/machinery/atmospherics/pipe/heat_exchanging/junction{
	dir = 4
	},
/obj/machinery/atmospherics/pipe/heat_exchanging/junction/layer4{
	dir = 4
	},
/obj/machinery/atmospherics/pipe/heat_exchanging/junction/layer2{
	dir = 4
	},
/turf/open/floor/iron/showroomfloor,
/area/ruin/space/has_grav/hellfactory)
"ag" = (
/obj/machinery/atmospherics/pipe/heat_exchanging/manifold{
	dir = 1
	},
/obj/machinery/atmospherics/pipe/heat_exchanging/manifold/layer2{
	dir = 1
	},
/obj/machinery/atmospherics/pipe/heat_exchanging/manifold/layer4{
	dir = 1
	},
/turf/open/floor/iron/showroomfloor,
/area/ruin/space/has_grav/hellfactory)
"ah" = (
/turf/closed/indestructible/reinforced,
/area/ruin/space/has_grav/hellfactoryoffice)
"ai" = (
/obj/structure/lattice/catwalk,
/obj/structure/cable,
/turf/template_noop,
/area/template_noop)
"aj" = (
/obj/structure/fluff/tram_rail/end,
/turf/template_noop,
/area/template_noop)
"al" = (
/obj/structure/cable,
/obj/machinery/power/solar,
/turf/open/floor/iron/solarpanel/airless,
/area/template_noop)
"ao" = (
/obj/structure/lattice,
/turf/template_noop,
/area/template_noop)
"ap" = (
/obj/structure/transit_tube/crossing,
/obj/structure/window/reinforced/spawner/directional/south,
/obj/structure/cable,
/obj/effect/decal/cleanable/dirt,
/turf/open/floor/iron,
/area/ruin/space/has_grav/hellfactory)
"aq" = (
/obj/machinery/conveyor/auto{
	dir = 1;
	id = "hellfactory_logistics_conveyors"
	},
/obj/effect/decal/cleanable/dirt,
/obj/machinery/door/poddoor/shutters{
	id = "hellfactory_freight_shutters_north"
	},
/turf/open/floor/plating/airless,
/area/ruin/space/has_grav/hellfactory)
"ar" = (
/obj/effect/decal/cleanable/dirt,
/obj/structure/table/wood/fancy/red,
/obj/item/paperwork/ancient,
/turf/open/floor/iron/grimy,
/area/ruin/space/has_grav/hellfactoryoffice)
"as" = (
/turf/open/floor/plating/rust,
/area/ruin/space/has_grav/hellfactory)
"at" = (
/obj/effect/decal/cleanable/dirt,
/obj/structure/window/reinforced/spawner/directional/north,
/obj/structure/transit_tube/crossing,
/obj/structure/cable,
/turf/open/floor/iron,
/area/ruin/space/has_grav/hellfactory)
"au" = (
/obj/machinery/atmospherics/pipe/heat_exchanging/simple{
	dir = 6
	},
/obj/machinery/atmospherics/pipe/heat_exchanging/simple/layer2{
	dir = 6
	},
/obj/machinery/atmospherics/pipe/heat_exchanging/simple/layer4{
	dir = 6
	},
/turf/open/floor/iron/showroomfloor,
/area/ruin/space/has_grav/hellfactory)
"av" = (
/obj/machinery/atmospherics/pipe/heat_exchanging/simple{
	dir = 4
	},
/obj/machinery/atmospherics/pipe/heat_exchanging/simple/layer4{
	dir = 4
	},
/obj/machinery/atmospherics/pipe/heat_exchanging/simple/layer2{
	dir = 4
	},
/obj/structure/holobox,
/turf/open/floor/iron/showroomfloor,
/area/ruin/space/has_grav/hellfactory)
"aw" = (
/obj/machinery/atmospherics/pipe/heat_exchanging/simple/layer4{
	dir = 4
	},
/obj/machinery/atmospherics/pipe/heat_exchanging/simple/layer2{
	dir = 4
	},
/obj/machinery/atmospherics/pipe/heat_exchanging/simple{
	dir = 4
	},
/turf/open/floor/iron/showroomfloor,
/area/ruin/space/has_grav/hellfactory)
"ax" = (
/obj/machinery/atmospherics/pipe/heat_exchanging/manifold{
	dir = 4
	},
/obj/machinery/atmospherics/pipe/heat_exchanging/manifold/layer2{
	dir = 4
	},
/obj/machinery/atmospherics/pipe/heat_exchanging/manifold/layer4{
	dir = 4
	},
/turf/open/floor/iron/showroomfloor,
/area/ruin/space/has_grav/hellfactory)
"az" = (
/obj/effect/decal/cleanable/dirt,
/obj/machinery/door/poddoor/shutters/window{
	id = "hellfactory_loading_unloading_shutters"
	},
/turf/open/floor/plating,
/area/ruin/space/has_grav/hellfactory)
"aA" = (
/obj/structure/chair/office/light{
	dir = 4
	},
/obj/effect/decal/cleanable/dirt,
/obj/structure/cable,
/turf/open/floor/wood,
/area/ruin/space/has_grav/hellfactory)
"aB" = (
/obj/effect/decal/cleanable/dirt,
/obj/structure/holosign/barrier/atmos/sturdy,
/turf/open/floor/plating,
/area/ruin/space/has_grav/hellfactory)
"aC" = (
/obj/machinery/atmospherics/pipe/heat_exchanging/simple,
/obj/machinery/atmospherics/pipe/heat_exchanging/simple/layer2,
/obj/machinery/atmospherics/pipe/heat_exchanging/simple/layer4,
/turf/open/floor/iron/showroomfloor,
/area/ruin/space/has_grav/hellfactory)
"aD" = (
/obj/structure/holobox,
/turf/open/floor/iron/showroomfloor,
/area/ruin/space/has_grav/hellfactory)
"aG" = (
/obj/machinery/conveyor/auto{
	id = "hellfactory_logistics_conveyors"
	},
/turf/open/floor/plating,
/area/ruin/space/has_grav/hellfactory)
"aH" = (
/obj/machinery/light/directional/south,
/turf/open/floor/plating,
/area/ruin/space/has_grav/hellfactory)
"aI" = (
/obj/machinery/conveyor/inverted{
	id = "hellfactory_logistics_conveyors";
	dir = 10
	},
/turf/open/floor/plating,
/area/ruin/space/has_grav/hellfactory)
"aJ" = (
/obj/structure/cable,
/obj/machinery/power/tracker,
/turf/open/floor/iron/solarpanel/airless,
/area/template_noop)
"aK" = (
/obj/docking_port/stationary{
	dir = 2;
	dwidth = 11;
	height = 24;
	name = "Hell Factory Loading Dock";
	shuttle_id = "whiteship_hellfactory";
	width = 35
	},
/turf/template_noop,
/area/template_noop)
"aL" = (
/obj/effect/decal/cleanable/dirt,
/obj/machinery/door/poddoor/shutters{
	id = "hellfactory_freight_shutters";
	dir = 1
	},
/turf/open/floor/plating/airless,
/area/ruin/space/has_grav/hellfactory)
"aM" = (
/obj/machinery/atmospherics/pipe/heat_exchanging/simple{
	dir = 5
	},
/obj/machinery/atmospherics/pipe/heat_exchanging/simple/layer2{
	dir = 5
	},
/obj/machinery/atmospherics/pipe/heat_exchanging/simple/layer4{
	dir = 5
	},
/turf/open/floor/iron/showroomfloor,
/area/ruin/space/has_grav/hellfactory)
"aN" = (
/obj/machinery/atmospherics/pipe/heat_exchanging/simple{
	dir = 4
	},
/obj/machinery/atmospherics/pipe/heat_exchanging/simple/layer2{
	dir = 4
	},
/obj/machinery/atmospherics/pipe/heat_exchanging/simple/layer4{
	dir = 4
	},
/turf/open/floor/iron/showroomfloor,
/area/ruin/space/has_grav/hellfactory)
"aO" = (
/obj/machinery/atmospherics/pipe/heat_exchanging/simple{
	dir = 9
	},
/obj/machinery/atmospherics/pipe/heat_exchanging/simple/layer2{
	dir = 9
	},
/obj/machinery/atmospherics/pipe/heat_exchanging/simple/layer4{
	dir = 9
	},
/turf/open/floor/iron/showroomfloor,
/area/ruin/space/has_grav/hellfactory)
"aP" = (
/obj/effect/decal/cleanable/dirt,
/obj/effect/mob_spawn/corpse/human/generic_assistant,
/turf/open/floor/iron,
/area/ruin/space/has_grav/hellfactory)
"aQ" = (
/obj/machinery/atmospherics/components/tank/water_vapor{
	dir = 4
	},
/turf/open/floor/iron/showroomfloor,
/area/ruin/space/has_grav/hellfactory)
"aR" = (
/obj/effect/decal/cleanable/dirt,
/obj/machinery/light/directional/east,
/turf/open/floor/iron,
/area/ruin/space/has_grav/hellfactory)
"aS" = (
/obj/effect/decal/cleanable/dirt,
/turf/template_noop,
/area/template_noop)
"aU" = (
/turf/open/floor/iron/showroomfloor,
/area/ruin/space/has_grav/hellfactory)
"aV" = (
/obj/effect/mine/gas/water_vapor,
/turf/open/floor/iron/showroomfloor,
/area/ruin/space/has_grav/hellfactory)
"aW" = (
/turf/closed/wall/r_wall/rust,
/area/ruin/space/has_grav/hellfactory)
"aZ" = (
/turf/open/floor/plating/airless,
/area/ruin/space/has_grav/hellfactory)
"ba" = (
/obj/effect/decal/cleanable/dirt,
/obj/structure/cable,
/turf/open/floor/iron,
/area/ruin/space/has_grav/hellfactory)
"bb" = (
/obj/effect/spawner/structure/window/reinforced,
/turf/open/floor/plating,
/area/ruin/space/has_grav/hellfactory)
"bf" = (
/obj/effect/decal/cleanable/dirt,
/obj/structure/window/reinforced/spawner/directional/north,
/turf/open/floor/iron,
/area/ruin/space/has_grav/hellfactory)
"bj" = (
/obj/machinery/conveyor/auto{
	id = "hellfactory_logistics_conveyors"
	},
/obj/effect/decal/cleanable/dirt,
/turf/open/floor/plating/airless,
/area/ruin/space/has_grav/hellfactory)
"bk" = (
/obj/effect/decal/cleanable/dirt,
/turf/open/floor/plating/airless,
/area/ruin/space/has_grav/hellfactory)
"bl" = (
/obj/effect/decal/cleanable/dirt,
/obj/structure/cable,
/obj/machinery/light_switch/directional/north,
/turf/open/floor/iron/grimy,
/area/ruin/space/has_grav/hellfactoryoffice)
"bm" = (
/obj/effect/decal/cleanable/dirt,
/turf/open/floor/wood/large,
/area/ruin/space/has_grav/hellfactory)
"bn" = (
/obj/machinery/door/poddoor/shutters{
	id = "hellfactory_freight_shutters"
	},
/turf/open/floor/plating/airless,
/area/ruin/space/has_grav/hellfactory)
"bo" = (
/obj/machinery/conveyor/auto{
	id = "hellfactory_logistics_conveyors"
	},
/obj/effect/decal/cleanable/dirt,
/obj/structure/holosign/barrier/atmos/sturdy,
/turf/open/floor/plating,
/area/ruin/space/has_grav/hellfactory)
"bp" = (
/obj/effect/decal/cleanable/dirt,
/obj/effect/turf_decal/stripes{
	dir = 4
	},
/turf/open/floor/iron,
/area/ruin/space/has_grav/hellfactory)
"bs" = (
/obj/effect/decal/cleanable/dirt,
/obj/effect/mob_spawn/corpse/human/skeleton,
/obj/structure/cable,
/turf/open/floor/iron/grimy,
/area/ruin/space/has_grav/hellfactoryoffice)
"bt" = (
/obj/effect/decal/cleanable/dirt,
/obj/structure/cable,
/turf/open/floor/iron/grimy,
/area/ruin/space/has_grav/hellfactoryoffice)
"bu" = (
/obj/machinery/door/puzzle/keycard/office,
/obj/effect/decal/cleanable/dirt,
/obj/structure/cable,
/turf/open/floor/iron/grimy,
/area/ruin/space/has_grav/hellfactoryoffice)
"bv" = (
/obj/effect/decal/cleanable/dirt,
/obj/structure/cable,
/turf/open/floor/wood,
/area/ruin/space/has_grav/hellfactory)
"bx" = (
/obj/structure/table/wood,
/obj/effect/decal/cleanable/dirt,
/obj/structure/cable,
/turf/open/floor/wood,
/area/ruin/space/has_grav/hellfactory)
"by" = (
/turf/open/floor/plating,
/area/ruin/space/has_grav/hellfactory)
"bB" = (
/obj/effect/decal/cleanable/dirt,
/turf/open/floor/iron/grimy,
/area/ruin/space/has_grav/hellfactoryoffice)
"bC" = (
/obj/effect/decal/cleanable/dirt,
/obj/machinery/light/directional/west,
/turf/open/floor/wood,
/area/ruin/space/has_grav/hellfactory)
"bD" = (
/obj/structure/table/wood,
/obj/effect/decal/cleanable/dirt,
/turf/open/floor/wood,
/area/ruin/space/has_grav/hellfactory)
"bE" = (
/obj/machinery/atmospherics/components/unary/thermomachine/freezer/on{
	dir = 8
	},
/obj/effect/decal/cleanable/dirt,
/turf/open/floor/iron,
/area/ruin/space/has_grav/hellfactory)
"bH" = (
/obj/structure/holosign/barrier/atmos/sturdy,
/obj/machinery/door/airlock/external{
	name = "Freezer Access"
	},
/turf/open/floor/plating,
/area/ruin/space/has_grav/hellfactory)
"bI" = (
/obj/machinery/conveyor/auto{
	dir = 5;
	id = "hellfactory_logistics_conveyors"
	},
/turf/open/floor/plating,
/area/ruin/space/has_grav/hellfactory)
"bJ" = (
/obj/machinery/conveyor/auto{
	id = "hellfactory_logistics_conveyors"
	},
/obj/effect/decal/cleanable/dirt,
/obj/structure/railing{
	dir = 8
	},
/obj/structure/railing{
	dir = 4
	},
/turf/open/floor/plating/airless,
/area/ruin/space/has_grav/hellfactory)
"bK" = (
/obj/effect/decal/cleanable/dirt,
/obj/machinery/door/airlock/engineering{
	name = "Manufacturing Wing Access"
	},
/turf/open/floor/iron,
/area/ruin/space/has_grav/hellfactory)
"bL" = (
/obj/effect/decal/cleanable/dirt,
/turf/open/floor/iron,
/area/ruin/space/has_grav/hellfactory)
"bP" = (
/obj/effect/decal/cleanable/dirt,
/obj/machinery/door/puzzle/keycard/stockroom,
/obj/structure/cable,
/turf/open/floor/iron,
/area/ruin/space/has_grav/hellfactory)
"bR" = (
/obj/machinery/door/airlock/external/glass,
/obj/effect/mapping_helpers/airlock/cyclelink_helper,
/obj/structure/cable,
/turf/open/floor/plating,
/area/ruin/space/has_grav/hellfactory)
"bU" = (
/obj/machinery/conveyor/auto{
	dir = 1;
	id = "hellfactory_logistics_conveyors"
	},
/obj/effect/decal/cleanable/dirt,
/turf/open/floor/plating/rust,
/area/ruin/space/has_grav/hellfactory)
"bV" = (
/obj/structure/cable,
/obj/effect/decal/cleanable/dirt,
/turf/open/floor/iron,
/area/ruin/space/has_grav/hellfactory)
"bW" = (
/obj/machinery/conveyor/auto{
	dir = 1;
	id = "hellfactory_logistics_conveyors"
	},
/obj/effect/decal/cleanable/dirt,
/obj/machinery/door/poddoor/shutters{
	id = "hellfactory_freight_shutters";
	dir = 1
	},
/turf/open/floor/plating/airless,
/area/ruin/space/has_grav/hellfactory)
"bZ" = (
/obj/machinery/door/airlock/external/glass,
/obj/effect/mapping_helpers/airlock/cyclelink_helper{
	dir = 8
	},
/turf/open/floor/plating,
/area/ruin/space/has_grav/hellfactory)
"ca" = (
/obj/effect/decal/cleanable/dirt,
/obj/structure/table/reinforced,
/turf/open/floor/iron,
/area/ruin/space/has_grav/hellfactory)
"cd" = (
/obj/machinery/conveyor/auto{
	dir = 1;
	id = "hellfactory_logistics_conveyors"
	},
/obj/effect/decal/cleanable/dirt,
/obj/structure/holosign/barrier/atmos/sturdy,
/turf/open/floor/plating,
/area/ruin/space/has_grav/hellfactory)
"cf" = (
/obj/effect/decal/cleanable/dirt,
/obj/machinery/door/airlock/mining{
	name = "Bridge Access"
	},
/turf/open/floor/iron,
/area/ruin/space/has_grav/hellfactory)
"ch" = (
/obj/machinery/atmospherics/pipe/heat_exchanging/simple,
/obj/machinery/atmospherics/pipe/heat_exchanging/simple/layer2,
/obj/machinery/atmospherics/pipe/heat_exchanging/simple/layer4,
/obj/machinery/light/directional/west,
/turf/open/floor/iron/showroomfloor,
/area/ruin/space/has_grav/hellfactory)
"ck" = (
/obj/machinery/power/terminal{
	dir = 4
	},
/obj/structure/cable,
/obj/machinery/power/solar_control{
	dir = 8
	},
/turf/open/floor/plating,
/area/ruin/space/has_grav/hellfactory)
"cm" = (
/obj/machinery/button/door/directional/south{
	id = "hellfactory_loading_unloading_shutters";
	name = "Airbridge Door Controls"
	},
/obj/effect/decal/cleanable/dirt,
/turf/open/floor/iron,
/area/ruin/space/has_grav/hellfactory)
"cn" = (
/obj/structure/fluff/tram_rail/end{
	dir = 8
	},
/turf/template_noop,
/area/template_noop)
"co" = (
/obj/machinery/power/smes,
/obj/structure/cable,
/turf/open/floor/plating,
/area/ruin/space/has_grav/hellfactory)
"cq" = (
/obj/structure/cable,
/turf/open/floor/plating,
/area/ruin/space/has_grav/hellfactory)
"cr" = (
/turf/template_noop,
/area/ruin/space/has_grav/hellfactory)
"cv" = (
/obj/machinery/conveyor/auto{
	id = "hellfactory_logistics_conveyors"
	},
/obj/machinery/door/poddoor/shutters{
	id = "hellfactory_loading_unloading_shutters"
	},
/obj/effect/decal/cleanable/dirt,
/turf/open/floor/plating,
/area/ruin/space/has_grav/hellfactory)
"cw" = (
/obj/machinery/light/directional/north,
/turf/open/floor/plating,
/area/ruin/space/has_grav/hellfactory)
"cx" = (
/obj/machinery/conveyor/auto{
	id = "hellfactory_logistics_conveyors"
	},
/obj/effect/decal/cleanable/dirt,
/obj/machinery/light/directional/west,
/turf/open/floor/plating,
/area/ruin/space/has_grav/hellfactory)
"cz" = (
/obj/effect/decal/cleanable/dirt,
/obj/structure/transit_tube/station/dispenser/reverse{
	dir = 8
	},
/obj/structure/cable,
/turf/open/floor/iron,
/area/ruin/space/has_grav/hellfactory)
"cB" = (
/obj/effect/decal/cleanable/dirt,
/turf/open/floor/plating/rust,
/area/ruin/space/has_grav/hellfactory)
"cD" = (
/obj/machinery/door/airlock/external/glass,
/obj/effect/mapping_helpers/airlock/cyclelink_helper{
	dir = 4
	},
/turf/open/floor/plating,
/area/ruin/space/has_grav/hellfactory)
"cE" = (
/obj/machinery/conveyor/auto{
	dir = 1;
	id = "hellfactory_logistics_conveyors"
	},
/obj/effect/decal/cleanable/dirt,
/turf/open/floor/plating,
/area/ruin/space/has_grav/hellfactory)
"cI" = (
/obj/machinery/conveyor/auto{
	id = "hellfactory_logistics_conveyors"
	},
/obj/effect/decal/cleanable/dirt,
/turf/open/floor/plating/rust,
/area/ruin/space/has_grav/hellfactory)
"cJ" = (
/obj/machinery/door/airlock/engineering{
	name = "Power Production"
	},
/obj/structure/cable,
/turf/open/floor/plating,
/area/ruin/space/has_grav/hellfactory)
"cK" = (
/turf/closed/wall/mineral/titanium/survival/nodiagonal,
/area/ruin/space/has_grav/hellfactory)
"cM" = (
/obj/machinery/conveyor/auto{
	id = "hellfactory_logistics_conveyors"
	},
/obj/effect/decal/cleanable/dirt,
/obj/machinery/door/poddoor/shutters{
	id = "hellfactory_freight_shutters";
	dir = 1
	},
/turf/open/floor/plating/airless,
/area/ruin/space/has_grav/hellfactory)
"cO" = (
/obj/structure/cable,
/obj/machinery/power/port_gen/pacman/pre_loaded,
/turf/open/floor/plating,
/area/ruin/space/has_grav/hellfactory)
"cQ" = (
/obj/structure/transit_tube/crossing,
/obj/structure/lattice/catwalk,
/obj/structure/cable,
/turf/template_noop,
/area/ruin/space/has_grav/hellfactory)
"cS" = (
/obj/machinery/conveyor/auto{
	dir = 1;
	id = "hellfactory_logistics_conveyors"
	},
/obj/effect/decal/cleanable/dirt,
/obj/machinery/light/directional/east,
/turf/open/floor/plating,
/area/ruin/space/has_grav/hellfactory)
"cV" = (
/obj/effect/decal/cleanable/dirt,
/obj/structure/cable,
/turf/open/floor/wood/large,
/area/ruin/space/has_grav/hellfactory)
"dm" = (
/obj/effect/turf_decal/stripes{
	dir = 8
	},
/turf/open/floor/plating,
/area/ruin/space/has_grav/hellfactory)
"dp" = (
/obj/machinery/button/door/directional/south{
	id = "hellfactory_output_lockdown";
	name = "Safety Shutters"
	},
/turf/template_noop,
/area/ruin/space/has_grav/hellfactory)
"gu" = (
/obj/machinery/door/puzzle/keycard/entry,
/obj/effect/decal/cleanable/dirt,
/turf/open/floor/iron,
/area/ruin/space/has_grav/hellfactory)
"hv" = (
/obj/machinery/button/door/directional/east{
	id = "hellfactory_freight_shutters";
	name = "Logistics Bridge Shutters"
	},
/turf/open/floor/plating,
/area/ruin/space/has_grav/hellfactory)
"iE" = (
/obj/machinery/conveyor/auto{
	dir = 9;
	id = "hellfactory_logistics_conveyors"
	},
/turf/open/floor/plating,
/area/ruin/space/has_grav/hellfactory)
"kD" = (
/obj/machinery/conveyor/auto{
	dir = 1;
	id = "hellfactory_logistics_conveyors"
	},
/obj/effect/decal/cleanable/dirt,
/obj/structure/railing{
	dir = 4
	},
/obj/structure/railing{
	dir = 8
	},
/turf/open/floor/plating/airless,
/area/ruin/space/has_grav/hellfactory)
"mu" = (
/obj/effect/decal/cleanable/dirt,
/obj/structure/table/wood/fancy/red,
/obj/item/paper_bin,
/obj/item/pen,
/turf/open/floor/iron/grimy,
/area/ruin/space/has_grav/hellfactoryoffice)
"nd" = (
/obj/structure/window/reinforced/spawner/directional/south,
/obj/effect/decal/cleanable/dirt,
/turf/open/floor/iron,
/area/ruin/space/has_grav/hellfactory)
"ow" = (
/obj/effect/decal/cleanable/dirt,
/obj/machinery/light/directional/south,
/turf/open/floor/iron,
/area/ruin/space/has_grav/hellfactory)
"oH" = (
/obj/machinery/atmospherics/pipe/layer_manifold/visible{
	dir = 4
	},
/turf/closed/wall/r_wall,
/area/ruin/space/has_grav/hellfactory)
"oJ" = (
/obj/effect/decal/cleanable/dirt,
/obj/effect/mob_spawn/corpse/human/cargo_tech,
/turf/open/floor/iron,
/area/ruin/space/has_grav/hellfactory)
"oL" = (
/obj/machinery/conveyor/auto{
	id = "hellfactory_logistics_conveyors"
	},
/obj/structure/plasticflaps/opaque,
/obj/machinery/door/poddoor/shutters{
	id = "hellfactory_output_lockdown"
	},
/turf/open/floor/plating,
/area/ruin/space/has_grav/hellfactory)
"oV" = (
/obj/machinery/door/puzzle/keycard/stockroom,
/turf/open/floor/iron,
/area/ruin/space/has_grav/hellfactory)
"sk" = (
/obj/machinery/conveyor/auto{
	dir = 1;
	id = "hellfactory_logistics_conveyors"
	},
/obj/effect/decal/cleanable/dirt,
/turf/open/floor/plating/airless,
/area/ruin/space/has_grav/hellfactory)
"uG" = (
/obj/effect/decal/cleanable/dirt,
/obj/structure/closet/secure_closet/personal/cabinet,
/obj/item/clothing/under/syndicate/sniper,
/obj/item/clothing/shoes/laceup,
/turf/open/floor/iron/grimy,
/area/ruin/space/has_grav/hellfactoryoffice)
"vB" = (
/obj/structure/closet/crate/engineering/electrical,
/obj/item/stack/sheet/mineral/plasma/thirty,
/obj/item/storage/toolbox/mechanical,
/turf/open/floor/plating,
/area/ruin/space/has_grav/hellfactory)
"wv" = (
/obj/machinery/conveyor_switch/oneway{
	id = "hellfactory_logistics_conveyors"
	},
/obj/machinery/light/directional/south,
/turf/open/floor/plating/rust,
/area/ruin/space/has_grav/hellfactory)
"xK" = (
/obj/machinery/conveyor_switch/oneway{
	id = "hellfactory_logistics_conveyors"
	},
/obj/effect/decal/cleanable/dirt,
/turf/open/floor/iron,
/area/ruin/space/has_grav/hellfactory)
"Cu" = (
/obj/effect/decal/cleanable/dirt,
/obj/structure/table/wood/fancy/red,
/obj/item/rsf,
/obj/machinery/light/small/directional/west,
/turf/open/floor/iron/grimy,
/area/ruin/space/has_grav/hellfactoryoffice)
"Ep" = (
/obj/effect/decal/cleanable/dirt,
/obj/structure/bed,
/obj/item/bedsheet/patriot,
/obj/structure/curtain/cloth/fancy,
/turf/open/floor/iron/grimy,
/area/ruin/space/has_grav/hellfactoryoffice)
"GE" = (
/obj/effect/turf_decal/stripes/corner{
	dir = 1
	},
/turf/open/floor/plating,
/area/ruin/space/has_grav/hellfactory)
"GU" = (
/obj/machinery/door/airlock/external/glass,
/obj/effect/mapping_helpers/airlock/cyclelink_helper{
	dir = 1
	},
/obj/structure/cable,
/turf/open/floor/plating,
/area/ruin/space/has_grav/hellfactory)
"Jy" = (
/obj/machinery/conveyor_switch/oneway{
	id = "hellfactory_logistics_conveyors"
	},
/obj/machinery/button/door/directional/west{
	id = "hellfactory_freight_shutters_north""hellfactory_freight_shutters_north";
	name = "Factory Transport Bridge Shutters"
	},
/obj/effect/turf_decal/stripes/corner{
	dir = 8
	},
/turf/open/floor/plating,
/area/ruin/space/has_grav/hellfactory)
"KZ" = (
/obj/machinery/conveyor/auto{
	id = "hellfactory_logistics_conveyors"
	},
/obj/effect/decal/cleanable/dirt,
/obj/machinery/door/poddoor/shutters{
	id = "hellfactory_freight_shutters_north"
	},
/turf/open/floor/plating/airless,
/area/ruin/space/has_grav/hellfactory)
"LZ" = (
/obj/structure/table/wood,
/obj/effect/decal/cleanable/dirt,
/obj/machinery/light_switch{
	name = "facility lighting switch"
	},
/turf/open/floor/wood,
/area/ruin/space/has_grav/hellfactory)
"OJ" = (
/obj/machinery/conveyor/inverted{
	id = "hellfactory_logistics_conveyors";
	dir = 6
	},
/turf/open/floor/plating,
/area/ruin/space/has_grav/hellfactory)
"Pk" = (
/obj/effect/decal/cleanable/dirt,
/obj/structure/table/wood/fancy/red,
/turf/open/floor/iron/grimy,
/area/ruin/space/has_grav/hellfactoryoffice)
"Pn" = (
/obj/effect/decal/cleanable/dirt,
/obj/structure/sign/flag/ssc/directional/south,
/turf/open/floor/iron/grimy,
/area/ruin/space/has_grav/hellfactoryoffice)
"QS" = (
/obj/machinery/atmospherics/pipe/heat_exchanging/junction{
	dir = 8
	},
/obj/machinery/atmospherics/pipe/heat_exchanging/junction/layer2{
	dir = 8
	},
/obj/machinery/atmospherics/pipe/heat_exchanging/junction/layer4{
	dir = 8
	},
/turf/open/floor/iron/showroomfloor,
/area/ruin/space/has_grav/hellfactory)
"Sz" = (
/obj/structure/transit_tube/station/dispenser/reverse{
	dir = 4
	},
/obj/structure/cable,
/obj/effect/decal/cleanable/dirt,
/turf/open/floor/iron,
/area/ruin/space/has_grav/hellfactory)
"UN" = (
/obj/structure/transit_tube,
/obj/structure/lattice/catwalk,
/obj/structure/cable,
/turf/template_noop,
/area/ruin/space/has_grav/hellfactory)
"Vd" = (
/obj/machinery/conveyor/auto{
	dir = 1;
	id = "hellfactory_logistics_conveyors"
	},
/obj/machinery/door/poddoor/shutters{
	id = "hellfactory_loading_unloading_shutters"
	},
/obj/effect/decal/cleanable/dirt,
/turf/open/floor/plating/rust,
/area/ruin/space/has_grav/hellfactory)
"VN" = (
/obj/machinery/door/airlock/grunge{
	name = "Managerial Office"
	},
/obj/effect/decal/cleanable/dirt,
/obj/structure/cable,
/turf/open/floor/wood/large,
/area/ruin/space/has_grav/hellfactory)
"Wh" = (
/obj/effect/decal/cleanable/dirt,
/turf/open/floor/plating,
/area/ruin/space/has_grav/hellfactory)
"XP" = (
/obj/effect/decal/cleanable/dirt,
/obj/machinery/light/small/directional/east,
/obj/item/gps/spaceruin{
	pixel_x = 4;
	pixel_y = 9
	},
/obj/structure/table/wood/fancy/red,
/turf/open/floor/iron/grimy,
/area/ruin/space/has_grav/hellfactoryoffice)
"ZL" = (
/obj/effect/decal/cleanable/dirt,
/obj/machinery/light/directional/north,
/turf/open/floor/iron,
/area/ruin/space/has_grav/hellfactory)

(1,1,1) = {"
aa
aa
aa
aa
aa
aa
aa
aa
aa
aa
aa
aa
aa
aa
aa
aa
aa
aa
aa
aa
aa
aa
aa
aa
aa
aa
aa
aa
aa
aa
aa
aa
aa
aa
aa
aa
aa
aa
aa
aa
aa
aa
aa
aa
aa
aa
aa
aa
aa
aa
aa
aa
aa
aa
aa
aa
aa
aa
aa
aa
aa
aa
aa
aa
aa
"}
(2,1,1) = {"
aa
aa
aa
aa
aa
aa
aa
aa
aa
aa
aa
aa
aa
aa
aa
aa
aa
aa
aa
aa
aa
aa
aa
aa
aa
aa
aa
aa
aa
aa
aa
aa
aa
aa
aa
aa
aa
aa
aa
aa
aa
aa
aa
aa
aa
aa
aa
aa
ah
ah
ah
ah
ah
ah
ah
aa
aa
aa
aa
aa
aa
aa
aa
aa
aa
"}
(3,1,1) = {"
aa
aa
aa
aa
aa
aa
aa
aa
aa
aa
aa
aa
aa
aa
aa
aa
aa
aa
aa
aa
aa
aa
aa
aa
aa
aa
aa
aa
aa
aa
aa
aa
al
ai
al
aa
al
ai
al
aa
al
ai
al
aa
al
ai
al
aa
ah
uG
mu
ar
Cu
Ep
ah
aa
bb
cD
bb
aa
aa
aa
aa
aa
aa
"}
(4,1,1) = {"
aa
aa
aa
aa
aa
aa
aa
aa
aa
aa
aa
aa
aa
aa
aa
aa
aa
aa
aa
aa
aa
aa
aa
aa
aa
aa
aa
aa
aa
aa
aa
aa
al
ai
al
aa
al
ai
al
aa
al
ai
al
aa
al
ai
al
aa
ah
bl
bt
bs
bB
Pn
ah
aa
bb
by
bb
aa
aa
aa
aa
aa
aa
"}
(5,1,1) = {"
aa
aa
aa
aa
aa
aa
aa
aa
aa
aa
aa
aa
aa
aa
aa
aa
aa
aa
aa
aa
aa
aa
aa
aa
aa
aa
aa
aa
aa
aa
aa
aa
al
ai
al
aa
al
ai
al
aa
al
ai
al
aa
al
ai
al
aa
ah
Pk
XP
bt
bB
bB
ah
bb
bb
bZ
bb
bb
bb
aa
aa
aa
aa
"}
(6,1,1) = {"
aa
aa
aa
ac
ac
ac
ac
ac
ac
ac
ac
ac
ac
ac
ac
ac
ac
aa
ac
ac
ac
ac
ac
ac
ac
ac
ac
ac
ac
ac
aa
aa
aa
ai
aa
aa
aa
ai
aa
aa
aa
ai
aa
aa
aa
ai
aa
aa
ah
ah
ah
bu
ah
ah
ah
bL
bL
bL
bL
bL
bb
aa
aa
aa
aa
"}
(7,1,1) = {"
aa
aa
aa
ac
cr
cr
cr
cr
cr
cr
cr
cr
cr
cr
cr
cr
ac
ao
ac
aQ
au
ch
aM
aU
ac
cO
cq
cq
cq
ac
ac
ac
aa
ai
aa
aa
aa
ai
aa
aa
aa
ai
aa
aa
aa
ai
aa
aa
ac
bm
bC
bv
bC
bm
ac
bL
ca
ca
ca
bL
bb
aa
aa
aa
aa
"}
(8,1,1) = {"
aa
aa
aa
ac
cr
cr
cr
cr
cr
cr
cr
cr
cr
cr
cr
cr
ac
aa
ac
ae
av
aU
aN
aU
ac
vB
by
by
cq
bR
cq
GU
ai
ai
ai
ai
ai
ai
ai
ai
ai
ai
ai
ai
ai
ai
aa
aa
aW
bm
LZ
aA
bD
bm
ac
bL
ca
aP
ca
bL
bb
aa
aa
aa
aa
"}
(9,1,1) = {"
aa
aa
aa
ac
cr
cr
cr
cr
cr
cr
cr
cr
cr
cr
cr
cr
ac
aa
ac
af
aw
aD
aN
aU
ac
cw
by
by
cq
ac
ac
ac
aa
aa
aa
aa
aa
aa
aa
ai
aa
aa
aa
aa
aa
aa
aa
aa
ac
bm
bD
bx
bD
bm
aW
bL
aR
bL
aR
bL
ac
aa
aa
aa
aa
"}
(10,1,1) = {"
aa
aa
aa
ac
cr
cr
cr
cr
cr
cr
cr
cr
cr
cr
cr
cr
ac
ao
ac
ag
ax
aC
aO
aU
ac
ad
cq
by
ck
ac
aa
aa
aa
aa
aa
aa
aa
aa
aa
ai
aa
aa
aa
aa
aa
aa
aa
aa
aW
bm
bm
cV
bm
bm
aW
ac
ac
gu
ac
ac
ac
aa
aa
cn
aa
"}
(11,1,1) = {"
aa
aa
aa
ac
cr
cr
cr
cr
cr
cr
cr
cr
cr
cr
cr
cr
ac
aa
ac
QS
aV
aU
aV
aU
ac
by
cq
cq
co
ac
aa
aa
aa
aa
aa
aa
aa
aa
aa
ai
aa
aa
aa
aa
aa
aa
aa
ac
aW
aW
bm
cV
bm
ac
ac
bL
bL
bL
bL
xK
ac
cK
cK
cK
aa
"}
(12,1,1) = {"
aa
aa
aa
ac
cr
cr
cr
cr
cr
cr
cr
cr
cr
cr
cr
cr
ac
ac
ac
oH
bH
ac
bH
ac
ac
ac
ac
cJ
ac
ac
ao
ao
ao
ao
ao
ao
ao
ao
ao
aJ
ao
ao
ao
ao
ao
ao
ao
ac
bL
ac
ac
VN
ac
ac
bL
bL
oJ
bL
bL
bL
ab
cI
ab
cv
aa
"}
(13,1,1) = {"
aa
aa
aa
ac
cr
cr
cr
cr
cr
cr
cr
cr
cr
cr
cr
cr
cr
ac
bL
bE
bL
bL
bL
bL
ow
ac
bL
bV
bL
nd
aa
aa
aa
aa
aa
aa
aa
aa
aa
aa
aa
aa
aa
aa
aa
aa
aa
bf
bL
bL
ac
ba
bL
ac
bL
bL
bL
bL
bL
bL
Wh
Wh
cB
az
aK
"}
(14,1,1) = {"
aa
aa
aa
ac
cr
cr
cr
cr
cr
cr
cr
cr
cr
cr
cr
cr
cr
oV
bL
bL
bL
bL
bL
bL
bL
oV
bL
bV
Sz
ap
UN
UN
UN
UN
UN
UN
UN
cQ
UN
UN
UN
UN
UN
UN
UN
UN
UN
at
cz
ba
bP
ba
bL
bK
bL
bL
bL
bL
bL
bL
cE
cE
bU
Vd
aa
"}
(15,1,1) = {"
aa
aa
aa
ac
cr
cr
cr
cr
cr
cr
cr
cr
cr
cr
cr
cr
cr
ac
ZL
bL
bL
bL
bL
bL
bL
ac
bL
bL
bL
nd
aa
aa
aa
aa
aa
aa
aa
aa
aa
aa
aa
aa
aa
aa
aa
aa
aa
bf
bL
ow
ac
bL
bL
ac
bL
bL
bL
bL
bL
cm
ac
cK
cK
cK
aa
"}
(16,1,1) = {"
aa
aa
aa
ac
cr
cr
cr
cr
cr
cr
cr
cr
cr
cr
cr
cr
cr
ac
ac
bp
bp
bp
bp
bp
bp
ac
ac
ac
ac
ac
ao
ao
ao
ao
ao
ao
ao
ao
ao
ao
ao
ao
ao
ao
ao
ao
ao
ac
bL
bL
ac
bL
aR
ac
bL
bL
bL
bL
bL
bL
ac
aa
aa
aj
aa
"}
(17,1,1) = {"
aa
aa
aa
ac
cr
cr
cr
cr
cr
cr
cr
cr
cr
cr
cr
dp
ac
ac
Jy
dm
dm
dm
dm
dm
dm
GE
aH
ac
aZ
ac
aa
aa
aa
aa
aa
aa
aa
aa
aa
aa
aa
aa
aa
aa
aa
aa
aa
ac
ac
ac
ac
ac
ac
ac
ac
ac
ac
cf
ac
ac
ac
aa
aa
aa
aa
"}
(18,1,1) = {"
aa
aa
aa
ac
cr
cr
cr
cr
cr
cr
cr
cr
cr
cr
cr
cr
oL
aG
aG
aG
aG
aG
aG
aG
aG
aG
ab
bo
bj
KZ
bJ
bJ
bJ
bJ
bJ
bJ
bJ
bJ
bJ
bJ
bJ
bJ
bJ
bJ
bJ
bJ
bJ
cM
bj
bo
ab
ab
ab
cx
ab
ab
ab
as
as
ac
aa
aa
aa
aa
aa
"}
(19,1,1) = {"
aa
aa
aa
ac
cr
cr
cr
cr
cr
cr
cr
cr
cr
cr
cr
cr
ac
cw
by
by
by
by
by
by
by
by
Wh
aB
bk
bn
aS
aS
aS
aS
aS
aS
aS
aS
aS
aS
aS
aS
aS
aS
aS
aS
aS
aL
bk
aB
Wh
Wh
Wh
Wh
Wh
Wh
Wh
by
wv
ac
aa
aa
aa
aa
aa
"}
(20,1,1) = {"
aa
aa
aa
ac
cr
cr
cr
cr
cr
cr
cr
cr
cr
cr
cr
cr
ac
by
by
bI
iE
bI
iE
bI
iE
bI
cE
cd
sk
aq
kD
kD
kD
kD
kD
kD
kD
kD
kD
kD
kD
kD
kD
kD
kD
kD
kD
bW
sk
cd
cS
cE
cE
cE
cE
cS
cE
hv
by
ac
aa
aa
aa
aa
aa
"}
(21,1,1) = {"
aa
aa
aa
ac
cr
cr
cr
cr
cr
cr
cr
cr
cr
cr
cr
cr
ac
by
by
aI
OJ
aI
OJ
aI
OJ
aI
aH
ac
aZ
ac
aa
aa
aa
aa
aa
aa
aa
aa
aa
aa
aa
aa
aa
aa
aa
aa
aa
ac
ac
ac
ac
ac
ac
ac
ac
ac
ac
ac
ac
ac
aa
aa
aa
aa
aa
"}
(22,1,1) = {"
aa
aa
aa
ac
ac
ac
ac
ac
ac
ac
ac
ac
ac
ac
ac
ac
ac
ac
ac
ac
ac
ac
ac
ac
ac
ac
ac
ac
ac
ac
aa
aa
aa
aa
aa
aa
aa
aa
aa
aa
aa
aa
aa
aa
aa
aa
aa
aa
aa
aa
aa
aa
aa
aa
aa
aa
aa
aa
aa
aa
aa
aa
aa
aa
aa
"}
(23,1,1) = {"
aa
aa
aa
aa
aa
aa
aa
aa
aa
aa
aa
aa
aa
aa
aa
aa
aa
aa
aa
aa
aa
aa
aa
aa
aa
aa
aa
aa
aa
aa
aa
aa
aa
aa
aa
aa
aa
aa
aa
aa
aa
aa
aa
aa
aa
aa
aa
aa
aa
aa
aa
aa
aa
aa
aa
aa
aa
aa
aa
aa
aa
aa
aa
aa
aa
"}
(24,1,1) = {"
aa
aa
aa
aa
aa
aa
aa
aa
aa
aa
aa
aa
aa
aa
aa
aa
aa
aa
aa
aa
aa
aa
aa
aa
aa
aa
aa
aa
aa
aa
aa
aa
aa
aa
aa
aa
aa
aa
aa
aa
aa
aa
aa
aa
aa
aa
aa
aa
aa
aa
aa
aa
aa
aa
aa
aa
aa
aa
aa
aa
aa
aa
aa
aa
aa
"}
(25,1,1) = {"
aa
aa
aa
aa
aa
aa
aa
aa
aa
aa
aa
aa
aa
aa
aa
aa
aa
aa
aa
aa
aa
aa
aa
aa
aa
aa
aa
aa
aa
aa
aa
aa
aa
aa
aa
aa
aa
aa
aa
aa
aa
aa
aa
aa
aa
aa
aa
aa
aa
aa
aa
aa
aa
aa
aa
aa
aa
aa
aa
aa
aa
aa
aa
aa
aa
"}
