//MAP CONVERTED BY dmm2tgm.py THIS HEADER COMMENT PREVENTS RECONVERSION, DO NOT REMOVE
"a" = (
/turf/template_noop,
/area/template_noop)
"c" = (
/obj/machinery/button/door/directional/east{
	id = "soviet_flagship_muni_cannon";
	name = "Cannon Hatch"
	},
/turf/open/floor/engine,
/area/shuttle/ruin/soviet_flagship/munitions)
"d" = (
/obj/effect/turf_decal/stripes/line,
/turf/open/floor/plating,
/area/shuttle/ruin/soviet_flagship/munitions)
"e" = (
/turf/closed/wall/r_wall/rust,
/area/shuttle/ruin/soviet_flagship/munitions)
"g" = (
/turf/open/floor/plating,
/area/shuttle/ruin/soviet_flagship/munitions)
"h" = (
/obj/effect/decal/cleanable/glass,
/turf/open/floor/engine,
/area/shuttle/ruin/soviet_flagship/munitions)
"j" = (
/obj/effect/decal/cleanable/glass/plastitanium,
/turf/open/floor/engine,
/area/shuttle/ruin/soviet_flagship/munitions)
"o" = (
/obj/effect/turf_decal/stripes/line{
	dir = 1
	},
/obj/item/shard,
/turf/open/floor/plating,
/area/shuttle/ruin/soviet_flagship/munitions)
"t" = (
/obj/effect/turf_decal/stripes/line{
	dir = 1
	},
/turf/open/floor/plating,
/area/shuttle/ruin/soviet_flagship/munitions)
"u" = (
/obj/item/shard,
/obj/effect/decal/cleanable/blood/old,
/turf/open/floor/engine,
/area/shuttle/ruin/soviet_flagship/munitions)
"v" = (
/obj/effect/turf_decal/stripes/line{
	dir = 4
	},
/turf/open/floor/plating,
/area/shuttle/ruin/soviet_flagship/munitions)
"w" = (
/turf/open/floor/engine,
/area/shuttle/ruin/soviet_flagship/munitions)
"x" = (
/obj/effect/decal/cleanable/glass/plasma,
/turf/open/floor/engine,
/area/shuttle/ruin/soviet_flagship/munitions)
"C" = (
/obj/effect/turf_decal/stripes/corner{
	dir = 4
	},
/turf/open/floor/plating,
/area/shuttle/ruin/soviet_flagship/munitions)
"D" = (
/obj/machinery/door/poddoor{
	id = "soviet_flagship_muni_cannon"
	},
/turf/open/floor/engine,
/area/shuttle/ruin/soviet_flagship/munitions)
"H" = (
/obj/machinery/atmospherics/components/unary/portables_connector/visible{
	dir = 1
	},
/turf/open/floor/engine,
/area/shuttle/ruin/soviet_flagship/munitions)
"J" = (
/obj/machinery/atmospherics/pipe/smart/manifold4w/orange/visible,
/turf/open/floor/engine,
/area/shuttle/ruin/soviet_flagship/munitions)
"M" = (
/turf/template_noop,
/area/shuttle/ruin/soviet_flagship/storage)
"N" = (
/obj/effect/turf_decal/stripes/line{
	dir = 8
	},
/turf/open/floor/engine/hull,
/area/shuttle/ruin/soviet_flagship/munitions)
"O" = (
/turf/closed/wall/r_wall,
/area/shuttle/ruin/soviet_flagship/munitions)
"V" = (
/obj/machinery/portable_atmospherics/canister/plasma,
/turf/open/floor/plating,
/area/shuttle/ruin/soviet_flagship/munitions)
"W" = (
/turf/open/floor/engine/hull,
/area/shuttle/ruin/soviet_flagship/munitions)
"X" = (
/obj/effect/turf_decal/stripes/corner,
/turf/open/floor/plating,
/area/shuttle/ruin/soviet_flagship/munitions)
"Y" = (
/obj/structure/frame/machine/secured,
/turf/open/floor/engine,
/area/shuttle/ruin/soviet_flagship/munitions)
"Z" = (
/obj/effect/turf_decal/stripes/line,
/obj/item/shard,
/turf/open/floor/plating,
/area/shuttle/ruin/soviet_flagship/munitions)

(1,1,1) = {"
a
a
a
a
a
a
a
a
a
a
a
a
a
a
a
a
a
a
a
a
a
a
a
a
a
a
a
a
a
a
"}
(2,1,1) = {"
a
a
a
a
a
a
a
a
a
a
a
a
a
a
a
a
a
a
a
a
a
a
a
a
a
a
a
a
a
a
"}
(3,1,1) = {"
a
a
a
a
a
a
a
a
a
a
a
a
a
a
a
a
a
a
a
a
a
a
a
a
a
a
a
a
a
a
"}
(4,1,1) = {"
a
a
a
a
a
a
a
a
a
a
a
a
a
a
a
a
a
a
a
a
a
a
a
a
a
a
a
a
a
a
"}
(5,1,1) = {"
a
a
a
a
a
a
a
a
a
a
a
a
a
a
a
a
a
a
a
a
a
a
a
a
a
a
a
a
a
a
"}
(6,1,1) = {"
a
a
a
a
a
a
a
a
a
a
a
a
a
a
a
a
a
a
a
a
a
a
a
a
a
a
a
a
a
a
"}
(7,1,1) = {"
a
a
a
a
a
a
a
a
a
a
a
a
a
a
a
a
a
a
a
a
a
a
a
a
a
a
a
a
a
a
"}
(8,1,1) = {"
a
a
a
a
a
a
a
a
a
a
a
a
a
a
a
a
a
a
a
a
a
a
a
a
a
a
a
a
a
a
"}
(9,1,1) = {"
a
a
a
a
a
a
a
a
a
a
a
a
a
a
a
a
a
a
a
a
a
a
a
a
a
a
a
a
a
a
"}
(10,1,1) = {"
a
a
a
a
a
a
a
a
a
a
a
a
a
a
a
a
a
a
a
a
a
a
a
a
a
a
a
a
a
a
"}
(11,1,1) = {"
a
a
a
a
a
a
a
a
a
a
a
a
a
a
a
a
a
a
a
a
a
a
a
a
a
a
a
a
a
a
"}
(12,1,1) = {"
a
a
a
a
a
a
a
a
a
a
a
a
a
a
a
a
a
a
a
a
a
a
a
a
a
a
a
a
a
a
"}
(13,1,1) = {"
a
a
a
a
a
a
a
a
a
a
a
a
a
a
a
a
a
a
a
a
a
a
a
a
a
a
a
a
a
a
"}
(14,1,1) = {"
a
a
a
a
a
a
a
a
a
a
a
a
a
a
a
a
a
a
a
a
a
a
a
a
a
a
a
a
a
a
"}
(15,1,1) = {"
a
a
a
a
a
a
a
a
a
a
a
a
a
a
a
a
a
a
a
a
a
a
a
a
a
a
a
a
a
a
"}
(16,1,1) = {"
a
a
a
a
a
a
a
a
a
a
a
a
a
a
a
a
a
a
a
a
a
a
a
a
a
a
a
a
a
a
"}
(17,1,1) = {"
a
a
a
a
a
a
a
a
a
a
a
a
a
a
a
a
a
a
a
a
a
a
a
a
a
a
a
a
a
a
"}
(18,1,1) = {"
a
a
a
a
a
a
a
a
a
a
a
a
a
a
a
a
a
a
a
a
a
a
a
a
a
a
a
a
a
a
"}
(19,1,1) = {"
a
a
a
a
a
a
a
a
a
a
a
a
a
a
a
a
a
a
a
a
a
a
a
a
a
a
a
a
a
a
"}
(20,1,1) = {"
a
a
a
a
a
a
a
a
a
a
a
a
a
a
a
a
a
a
a
a
a
a
a
a
a
a
a
a
a
a
"}
(21,1,1) = {"
a
a
a
a
a
a
a
a
a
a
a
a
a
a
a
a
a
a
a
a
a
a
a
a
a
a
a
a
a
a
"}
(22,1,1) = {"
a
a
a
a
a
a
a
a
a
a
a
a
a
a
a
a
a
a
a
a
a
a
a
a
a
a
a
a
a
a
"}
(23,1,1) = {"
a
a
a
a
a
a
a
a
a
a
a
a
a
a
a
a
a
a
a
a
a
a
a
a
a
a
a
a
a
a
"}
(24,1,1) = {"
a
a
a
a
a
a
a
a
a
a
a
a
a
a
a
a
a
a
a
a
a
a
a
a
a
a
a
a
a
a
"}
(25,1,1) = {"
a
a
a
a
a
a
a
a
a
a
a
a
a
a
a
a
a
a
a
a
a
a
a
a
a
a
a
a
a
a
"}
(26,1,1) = {"
a
a
a
a
a
a
a
a
a
a
a
a
a
a
a
a
a
a
a
a
a
a
a
a
a
a
a
a
a
a
"}
(27,1,1) = {"
a
a
a
a
a
a
a
a
a
a
a
a
a
a
a
a
a
a
a
a
a
a
a
a
a
a
a
a
a
a
"}
(28,1,1) = {"
a
a
a
a
a
a
a
a
a
a
a
a
a
a
a
a
a
a
a
a
a
a
a
a
a
a
a
a
a
a
"}
(29,1,1) = {"
a
a
a
a
a
a
a
a
a
a
a
a
a
a
a
a
a
a
a
a
a
a
a
a
a
a
a
a
a
a
"}
(30,1,1) = {"
a
a
a
a
a
a
a
a
a
a
a
a
a
a
a
a
a
a
a
a
a
a
a
a
a
a
a
a
a
a
"}
(31,1,1) = {"
a
a
a
a
a
a
a
a
a
a
a
a
a
a
a
a
a
a
a
a
a
a
a
a
a
a
a
a
a
a
"}
(32,1,1) = {"
a
a
a
a
a
a
a
a
a
a
a
a
a
a
a
a
a
a
a
a
a
a
a
a
a
a
a
a
a
a
"}
(33,1,1) = {"
a
a
a
a
a
a
a
a
a
a
a
a
a
a
a
a
a
a
a
a
a
a
a
a
a
a
a
a
a
a
"}
(34,1,1) = {"
a
a
a
a
a
a
a
a
a
a
a
a
a
a
a
a
a
a
a
a
a
a
a
a
a
a
a
a
a
a
"}
(35,1,1) = {"
a
a
a
a
a
a
a
a
a
a
a
a
a
a
a
a
a
a
a
a
a
a
a
a
a
a
a
a
a
a
"}
(36,1,1) = {"
a
a
a
a
a
a
a
a
a
a
a
a
a
a
a
a
a
a
a
a
a
a
a
a
a
a
a
a
a
a
"}
(37,1,1) = {"
a
a
a
a
a
a
a
a
a
a
a
a
a
a
a
a
a
a
a
a
a
a
a
a
a
a
a
a
a
a
"}
(38,1,1) = {"
a
a
a
a
a
a
a
a
a
a
a
a
a
a
a
a
a
a
a
a
a
a
a
a
a
a
a
a
a
a
"}
(39,1,1) = {"
a
a
a
a
a
a
a
a
a
a
a
a
a
a
a
a
a
a
a
a
a
a
a
a
a
a
a
a
a
a
"}
(40,1,1) = {"
a
a
a
a
a
a
a
a
a
a
a
a
a
a
a
a
a
a
a
a
a
a
a
a
a
a
a
a
a
a
"}
(41,1,1) = {"
a
a
a
a
a
a
a
a
a
a
a
a
a
a
a
a
a
a
a
a
a
a
a
a
a
a
a
a
a
a
"}
(42,1,1) = {"
a
a
a
a
a
a
a
a
a
a
a
a
a
a
a
a
a
a
a
a
a
a
a
a
a
a
a
a
a
a
"}
(43,1,1) = {"
a
a
a
a
a
a
a
a
a
a
a
a
a
a
a
a
a
a
a
a
a
a
a
a
a
a
a
a
a
a
"}
(44,1,1) = {"
a
a
a
a
a
a
a
a
a
a
a
a
a
a
a
a
a
a
a
a
a
a
a
a
a
a
a
a
a
a
"}
(45,1,1) = {"
a
a
a
a
a
a
a
a
a
a
a
a
a
a
a
a
a
a
a
a
a
a
a
a
a
a
a
a
a
a
"}
(46,1,1) = {"
a
a
a
a
a
a
a
a
a
a
a
a
a
a
a
a
a
a
a
a
a
a
a
a
a
a
a
a
a
a
"}
(47,1,1) = {"
a
a
a
a
a
a
a
a
a
a
a
a
a
a
a
a
a
a
a
a
a
a
a
a
a
a
a
a
a
a
"}
(48,1,1) = {"
a
a
a
a
a
a
a
a
a
a
a
a
a
a
a
a
a
a
a
a
a
a
a
a
a
a
a
a
a
a
"}
(49,1,1) = {"
a
a
a
a
a
a
a
a
a
a
a
a
a
a
a
a
a
a
a
a
a
a
a
a
a
a
a
a
a
a
"}
(50,1,1) = {"
a
a
a
a
a
a
a
a
a
a
a
a
a
a
a
a
a
a
a
a
a
a
a
a
a
a
a
a
a
a
"}
(51,1,1) = {"
a
a
a
a
a
a
a
a
a
a
a
a
a
a
a
a
a
a
a
a
a
a
a
a
a
a
a
a
a
a
"}
(52,1,1) = {"
a
a
a
a
a
a
a
a
a
a
a
a
a
a
a
a
a
a
a
a
a
a
a
a
a
a
a
a
a
a
"}
(53,1,1) = {"
a
a
a
a
a
a
a
a
a
a
a
a
a
a
a
a
a
a
a
a
a
a
a
a
a
a
a
a
a
a
"}
(54,1,1) = {"
a
a
a
a
a
a
a
a
a
a
a
a
a
a
a
a
a
a
a
a
a
a
a
a
a
a
a
a
a
a
"}
(55,1,1) = {"
a
a
a
a
a
a
a
a
a
a
a
a
a
a
a
a
a
a
a
a
a
a
a
a
a
a
a
a
a
a
"}
(56,1,1) = {"
a
a
a
a
a
a
a
a
a
a
a
a
a
a
a
a
a
a
a
a
a
a
a
a
a
a
a
a
a
a
"}
(57,1,1) = {"
a
a
a
a
a
a
a
a
a
a
a
a
a
a
a
a
a
a
a
a
a
a
a
a
a
a
a
a
a
a
"}
(58,1,1) = {"
a
a
a
a
a
a
a
a
a
a
a
a
a
a
a
a
a
a
a
a
a
a
a
a
a
a
a
a
a
a
"}
(59,1,1) = {"
a
M
M
M
M
M
M
M
a
a
a
a
a
a
a
a
a
e
g
X
v
v
v
v
C
g
g
O
a
a
"}
(60,1,1) = {"
a
M
M
M
M
M
M
M
a
a
a
a
a
a
a
a
a
e
g
d
w
w
x
w
t
g
g
e
a
a
"}
(61,1,1) = {"
a
M
M
M
M
M
M
M
a
a
a
a
a
a
a
a
a
e
g
Z
w
Y
w
w
t
V
g
e
a
a
"}
(62,1,1) = {"
a
M
M
M
M
M
M
M
a
a
a
a
a
a
a
a
a
e
g
d
w
w
h
w
o
g
g
e
a
a
"}
(63,1,1) = {"
a
M
M
M
M
M
M
M
a
a
a
a
a
a
a
a
a
O
g
d
j
J
J
H
t
g
g
O
a
a
"}
(64,1,1) = {"
a
a
M
M
M
M
M
M
a
a
a
a
a
a
a
a
a
O
g
d
w
J
w
w
t
g
g
O
a
a
"}
(65,1,1) = {"
a
a
M
M
M
M
M
M
a
a
a
a
a
a
a
a
a
e
g
d
u
w
Y
w
t
g
O
O
a
a
"}
(66,1,1) = {"
a
a
M
M
M
M
M
M
a
a
a
a
a
a
a
a
a
e
g
d
w
Y
j
w
o
g
O
a
a
a
"}
(67,1,1) = {"
a
a
a
M
M
M
M
M
a
a
a
a
a
a
a
a
a
e
g
d
w
h
w
c
t
O
O
a
a
a
"}
(68,1,1) = {"
a
a
a
M
M
M
M
M
a
a
a
a
a
a
a
a
a
O
O
d
e
D
D
e
t
O
a
a
a
a
"}
(69,1,1) = {"
a
a
a
a
M
M
M
M
a
a
a
a
a
a
a
a
a
a
O
e
e
N
N
e
O
e
a
a
a
a
"}
(70,1,1) = {"
a
a
a
a
M
M
M
M
a
a
a
a
a
a
a
a
a
a
a
a
e
W
W
O
a
a
a
a
a
a
"}
